- - - t - - - g
* - * * * t * c
* - * - t - * t
- - * - * * * -
* - * - * * * t
* - - - - - - -
* - * * * * * -
v - - - - - * -