- - - a - - - g
- - * * * * - -
- * * * - c - -
- - - * - * t *
* * - * - - - *
* t - - - * - -
* - * * - * * *
v - - T - - * *