* * * - - - - g
* - - t * - T *
* - - * * * - *
- - - - * * - *
* * * - - - - -
- - c - * * - -
- * * - - * - -
v - - - - * - -