* * * * * - - g
- * - - t - - -
- - - * * * * -
* * - - - * c -
- * * - * * - *
- T - - - - - -
- * * t * * * *
v - - - - - * *