- - c - - - - g
* * t * * * - -
- - - - - t - -
- - - * * * * -
* * - * - * * a
* - - - - - * -
* - * * * - * -
v - - - * - - -