- - - - * * * g
- - - - - - T -
* * * - * * - -
- - * - * * * -
- - - - - * T -
- * c * - - - *
- * - * - - - *
v - - * - * * *