- - - - - - * g
- * - - - - * -
- * * - * - t -
- - * - * * * T
* - * - - * * -
* - t - - - - -
* - * - - * * -
v - - T * * * *