* * - t - t c g
* - - * * * * -
* - - * * T - -
* * - * * t * -
- * - - - - * T
- * - - - - - -
- - - * * * * -
v * - - - - - -