* * - * - - - g
* * - - c * - -
- * - * * * - -
- * - * - * T *
- t - - - * - *
- * - * - - - *
- * T * * - * *
v - - - * - - *