- - - t - - - g
- * - * * - * c
- * - - t t * t
- * - - * * * -
- * - - * * * t
- - - - - - - -
* - * * * - - *
v - - - * * * *