- - - * * - - g
- * - t c - - -
- * - * * * T *
- * - * * * - *
- * - * * * - *
- - - - - - - *
- * * - - - * *
v * * * * - - -