- - - t - t c g
* * - * * * * -
- * - * * - t -
- * - * * T * -
- * - - - - * T
- * - * * * * -
- - - - - - - -
v * * * - * * -