- - - a - - - g
- * * * * - - -
- - - * * T * -
* * - - * - * -
- * - * * - * -
- * - - - - t c
- - - * - - * -
v * * * - - * -