* - - - T - - g
* * - * * T * *
* * - * * - - -
* - - - * * - -
T - - - - - - -
- * t * * * - -
- - - - - * * -
v * * * - - - -