- * * * * * - g
- * - - - t - -
- - - * * * - -
* - - * * * c *
* - - * * * t *
* * - - - - - -
* * - * * * * -
v - - - - - - -