* * - * * - - g
* * - - T - - -
- * * - * c * -
- - - - - - * -
T * - * * * * a
- * - - - * * -
- - t * - * - -
v * * * - - - -